{
  "name": "1",
  "stage": [
    "_#__#__#__#__#__#__#__#__#_",
    "_#__ __ __ __ __ __ __ __#_",
    "_#__ __ __ __ __ __ __ __#_",
    "_#__ __ __ __ __ __ __ __#_",
    "_#__ __ __ __pd_ __ __ __#_",
    "_#__ __ __ __ __ __ __ __#_",
    "_#__ __ __ __ __ __ __ __#_",
    "_#__ __ __ __ __ __ __ __#_",
    "_#__#__#__#__#__#__#__#__#_"
  ]
}